C,C,C,C,C,C,C,C,C,C,C,C
C,E,E,E,E,C,C,E,E,C,E,E
C,E,E,E,E,C,C,E,E,C,E,E
C,E,C,C,C,C,C,E,E,E,E,E
C,E,C,E,E,E,E,E,E,E,E,E
C,C,C,C,C,C,C,C,C,C,C,C
C,E,E,E,C,C,C,E,E,E,E,C
C,E,C,E,C,C,C,E,E,E,E,C
C,E,C,E,C,C,C,E,E,C,C,C
C,E,C,E,E,C,C,C,C,C,E,C
C,E,C,E,E,C,C,E,E,E,E,C
C,C,C,C,C,C,C,C,C,C,C,C